Doniczka - Pot
Kłos - Spike
Przyjazny - Friendly
Żaba - Frog
Życie - Life
Wąż - Snake
Krowa - Cow
Zwierzę - Animal
Dom - House
Dziecko - Child
Drzewo - Tree
Szczęście - Happiness
Wiatr - Wind
Piasek - Sand
Księżyc - Moon
Zima - Winter
Słońce - Sun
Lato - Summer
Woda - Water
Ogień - Fire
Natura - Nature
Ptak - Bird
Słodka - Sweet
Krzywy - Crooked
Mądry - Wise
Ziemia - Earth
Wysoki - Tall
Głęboki - Deep
Jasny - Bright
Czarny - Black
Światło - Light
Ciepły - Warm
Chłodny - Cool
Mglisty - Misty
Wielki - Great
Mały - Small
Miły - Lovely
Zabawny - Funny
Ostrożny - Careful
Ciężki - Heavy
Lekki - Light
Wzruszający - Moving
Gorący - Hot
Świetny - Brilliant
Przerażający - Terrifying
Niezwykły - Unusual
Błękitny - Blue
Żółty - Yellow
Różowy - Pink
Zielony - Green
Szary - Grey
Szczęśliwy - Happy
Zły - Bad
Słaby - Weak
Mocny - Strong
Spokojny - Calm
Szybki - Fast
Powolny - Slow
Przyjemny - Pleasant
Przerażający - Frightening
Przyjazny - Kind
Niegrzeczny - Naughty
Łagodny - Gentle
Wściekły - Furious
Wścibski - Nosy
Przystojny - Handsome
Brzydki - Ugly
Przypadkowy - Random
Długi - Long
Krótki - Short
Szeroki - Wide
Wąski - Narrow
Łatwy - Easy
Trudny - Difficult
Łagodny - Mild
Ostre - Sharp
Łaskawy - Gracious
Skromny - Modest
Tęgi - Thick
Cienki - Thin
Pracowity - Hardworking
Leniwy - Lazy
Przestępny - Criminal
Legalny - Legal
Przyzwoity - Decent
Nieokrzesany - Rude
Świeży - Fresh
Staroświecki - Old-fashioned
Nowoczesny - Modern
Przyzwoity - Respectable
Zdeterminowany - Determined
Bezsilny - Powerless
Przyjacielski - Friendly
Nieprzyjacielski - Unfriendly
Przemądrzały - Overconfident
Przystępny - Accessible
Złośliwy - Malicious
Wygodny - Comfortable
Niewygodny - Uncomfortable
Niewyczerpany - Unending
